IIIIIIIIIII
IMMMMMMMMMI
IMK  S   MI
IM B    dMI
IM       MI
IM    s  MI
IMMMMMMMMMI